-15
20
-8
12
000000000000000000000000000000000000
111111111111111111111111111111111110
000000000000000000000000000000000000
000000000000000000000000000000000000
000000000000000000000000000000000000
000000000011000000011000000000000000
000000000011111000011000000000000000
000000000000000000011000000000000000
000000011100000000000000000000000000
000000000000000000000001000000000000
000000000000000000000000000000000000
000000000000000000000000000000000000
000000000000000000000000000000000000
000000000000000000000000000000000000
000000000000000000000000000000000000
000000000000000000000000000000000000
000000000000000000000000000000000000
000000000000000000000000000000000000
000000000000000000000000000000000000
000000000000000000000000000000000000
000000000000000000000000000000000000
